10  2   2   2   2   2   2   2   2
2   2   2   2   2   2   2   2   2
2   2   2   2   2   2   2   2   2
2   2   10  2   2   2   2   2   2
2   2   2   2   10  2   2   2   2
2   2   2   2   2   2   2   2   2
2   2   10  1   10  10  10  2   2
2   2   10  2   10  2   2   2   2
2   2   10  10  10  2   2   2   2
2   2   2   2   2   2   2   2   2
2   2   10  2   2   2   2   2   2
2   2   2   2   2   10  2   2   2
2   2   2   1   2   2   2   2   2
2   2   2   1   2   2   2   2   2
2   2   2   2   2   2   2   2   2
2   10  1   2   10  2   2   2   2